A	EY
AGAIN	AH G EH N
AT	AE T
B	B IY
BIN	B IH N
BLUE	B L UW
BY	B AY
C	S IY
D	D IY
E	IY
EIGHT	EY T
F	EH F
FIVE	F AY V
FOUR	F AO R
G	JH IY
GREEN	G R IY N
H	EY CH
I	AY
IN	IH N
J	JH EY
K	K EY
L	EH L
LAY	L EY
M	EH M
N	EH N
NINE	N AY N
NOW	N AW
O	OW
ONE	W O N
P	P IY
PLACE	P L EY S
PLEASE	P L IY Z
Q	K Y UW
R	AA R
RED	R EH D
S	EH S
SET	S EH T
SEVEN	S EH V AH N
SIX	S IH K S
SOON	S UW N
T	T IY
THREE	TH R IY
TWO	T UW
U	Y UW
V	V IY
WHITE	W AY T
WITH	W IH DH
X	EH K S
Y	W AY
Z	Z IY
ZERO	Z IH R OW
